###########################
#            M            #
#                         #
#                         #
#                         #
#                         #
#            *            #
#           ***           #
#          *****          #
#M        *******        M#
#          *****          #
#           ***           #
#            *            #
#                         #
#                         #
#                         #
#                         #
#            ^            #
###########################
