###############################
#              M              #
#                             #
#                             #
#                             #
#                             #
#              *              #
#             ***             #
#            *****            #
#M          *******          M#
#            *****            #
#             ***             #
#              *              #
#                             #
#                             #
#                             #
#                             #
#              ^              #
###############################
